12,0,0,0,0,0,19,0,0,0,0,0,0,0,0,19
14,0,0,0,0,0,20,0,0,0,0,0,16,0,0,16
13,0,0,0,0,0,1,0,0,0,1,0,0,0,0,20
11,0,0,0,14,12,21,0,0,0,0,0,0,0,0,17
9,0,0,0,2,0,0,0,0,0,0,2,25,0,0,7
8,0,0,0,25,0,0,0,0,0,0,0,0,0,0,0
0,0,0,0,0,0,0,0,0,0,0,0,13,21,0,0
0,0,0,6,24,0,0,0,0,0,0,0,0,18,0,0
0,0,0,0,0,0,0,0,0,0,0,0,0,0,0,0
0,0,0,0,0,0,0,0,0,0,15,0,0,0,0,0
0,0,0,0,5,0,0,0,0,0,0,6,24,0,0,0
0,0,0,0,23,0,0,0,0,0,0,5,23,0,0,0
8,0,0,0,0,0,0,0,0,0,0,0,0,0,0,7
10,9,0,0,22,0,0,0,0,0,0,0,22,0,0,0
0,11,0,15,3,0,0,0,0,0,0,3,4,0,0,0
0,0,10,4,0,0,0,0,0,0,0,0,0,18,0,17
