5,0,0,5,10,0,0,0
6,0,7,0,0,0,7,10
4,0,11,0,0,0,0,3
0,6,1,0,0,1,0,0
0,9,0,0,9,11,0,0
0,2,0,0,0,2,12,0
4,12,0,0,0,0,0,3
8,0,0,0,0,0,0,8
